blitzcrank	Q>E>W
brand	W>Q>E
braum	Q>E>W
caitlyn	Q>W>E
camille	E>Q>W
cassiopeia	Q>W>E
chogath	E>Q>W
corki	Q>E>W
darius	Q>E>W
diana	Q>W>E
drmundo	Q>E>W
draven	Q>W>E
ekko	Q>E>W
elise	Q>W>E
evelynn	Q>E>W
ezreal	Q>E>W
fiddlesticks	E>Q>W
fiora	Q>E>W
fizz	E>W>Q
galio	Q>W>E
gangplank	Q>E>W
garen	Q>E>W
gnar	Q>W>E
gragas	Q>E>W
graves	Q>E>W
hecarim	Q>E>W
heimerdinger	Q>W>E
illaoi	E>Q>W
irelia	Q>E>W
ivern	E>Q>W
janna	W>E>Q
jarvaniv	Q>E>W
jax	W>Q>E
jayce	Q>W>E
jhin	Q>W>E
jinx	Q>W>E
kaisa	Q>E>W
kalista	E>Q>W
karma	Q>E>W
karthus	Q>E>W
kassadin	Q>E>W
katarina	Q>E>W
kayle	E>Q>W
kayn	Q>W>E
kennen	Q>W>E
khazix	Q>W>E
kindred	Q>W>E
kled	Q>W>E
kogmaw	W>Q>E
leblanc	W>Q>E
leesin	Q>W>E
leona	W>Q>E
lissandra	Q>W>E
lucian	Q>E>W
lulu	E>W>Q
lux	E>Q>W
malphite	Q>E>W
malzahar	E>Q>W
maokai	Q>W>E
masteryi	Q>E>W
missfortune	Q>W>E
mordekaiser	W>Q>E
morgana	Q>W>E
nami	W>E>Q
nasus	Q>E>W
nautilus	E>W>Q
neeko	Q>E>W
nidalee	Q>E>W
nocturne	Q>E>W
nunu	Q>W>E
olaf	Q>E>W
orianna	Q>W>E
ornn	W>Q>E
pantheon	Q>E>W
poppy	Q>E>W
pyke	Q>E>W
quinn	Q>E>W
rakan	Q>E>W
rammus	Q>E>W
reksai	Q>E>W
renekton	Q>E>W
rengar	Q>E>W
riven	Q>E>W
rumble	Q>E>W
ryze	Q>E>W
sejuani	W>E>Q
shaco	Q>E>W
shen	Q>E>W
shyvana	W>E>Q
singed	Q>E>W
sion	Q>W>E
sivir	Q>W>E
skarner	Q>W>E
sona	Q>W>E
soraka	W>Q>E
swain	Q>E>W
sylas	Q>W>E
syndra	Q>E>W
tahmkench	Q>W>E
taliyah	Q>E>W
talon	W>Q>E
taric	E>Q>W
teemo	E>Q>W
thresh	Q>E>W
tristana	E>Q>W
trundle	Q>W>E
tryndamere	Q>E>W
twistedfate	Q>W>E
twitch	E>Q>W
udyr	Q>E>W
urgot	Q>W>E
varus	Q>W>E
vayne	Q>W>E
veigar	Q>W>E
velkoz	Q>W>E
vi	Q>E>W
viktor	E>Q>W
vladimir	Q>E>W
volibear	W>Q>E
warwick	W>Q>E
wukong	E>Q>W
xayah	E>W>Q
xerath	Q>W>E
xinzhao	W>E>Q
yasuo	Q>E>W
yorick	Q>E>W
zac	E>W>Q
zed	Q>E>W
ziggs	Q>E>W
zilean	Q>W>E
zoe	Q>E>W
zyra	Q>E>W
