blitzcrank	Boots of Mobility,Remnant of the Aspect,Zeke's Convergence,Knight's Vow,Locket of the Iron Solari,Redemption,
brand	Sorcerer's Shoes,Liandry's Torment,Rylai's Crystal Scepter,Remnant of the Watchers,Void Staff,Rabadon's Deathcap,
braum	Remnant of the Aspect,Boots of Mobility,Knight's Vow,Locket of the Iron Solari,Redemption,Randuin's Omen,
caitlyn	Stormrazor,Berserker's Greaves,Rapid Firecannon,Infinity Edge,The Bloodthirster,Guardian Angel,
camille	Enchantment: Warrior,Ninja Tabi,Trinity Force,Sterak's Gage,Guardian Angel,Ravenous Hydra,
cassiopeia	Rylai's Crystal Scepter,Liandry's Torment,Morellonomicon,Rabadon's Deathcap,Void Staff,Void Staff,
chogath	Ninja Tabi,Righteous Glory,Warmog's Armor,Gargoyle Stoneplate,Spirit Visage,Thornmail,
corki	Trinity Force,Sorcerer's Shoes,Rapid Firecannon,Infinity Edge,Guardian Angel,Maw of Malmortius,
darius	Ninja Tabi,Trinity Force,Sterak's Gage,Dead Man's Plate,Spirit Visage,Guardian Angel,
diana	Nashor's Tooth,Sorcerer's Shoes,Zhonya's Hourglass,Rabadon's Deathcap,Void Staff,Rylai's Crystal Scepter,
drmundo	Sunfire Cape,Ninja Tabi,Spirit Visage,Warmog's Armor,Thornmail,Randuin's Omen,
draven	The Bloodthirster,Berserker's Greaves,Stormrazor,Rapid Firecannon,Infinity Edge,Guardian Angel,
ekko	Hextech Protobelt-01,Sorcerer's Shoes,Lich Bane,Zhonya's Hourglass,Morellonomicon,Rabadon's Deathcap,
elise	Enchantment: Runic Echoes,Sorcerer's Shoes,Morellonomicon,Zhonya's Hourglass,Liandry's Torment,Banshee's Veil,
evelynn	Enchantment: Runic Echoes,Sorcerer's Shoes,Lich Bane,Morellonomicon,Zhonya's Hourglass,Rabadon's Deathcap,
ezreal	Manamune,Ionian Boots of Lucidity,Archangel's Staff,Hextech Gunblade,Guardian Angel,Guardian Angel,
fiddlesticks	Boots of Mobility,Zhonya's Hourglass,Remnant of the Watchers,Morellonomicon,Rylai's Crystal Scepter,Rabadon's Deathcap,
fiora	Ninja Tabi,Ravenous Hydra,Trinity Force,Sterak's Gage,Guardian Angel,Mercurial Scimitar,
fizz	Hextech Protobelt-01,Sorcerer's Shoes,Lich Bane,Zhonya's Hourglass,Rabadon's Deathcap,Void Staff,
galio	Hextech Protobelt-01,Sorcerer's Shoes,Morellonomicon,Zhonya's Hourglass,Rabadon's Deathcap,Void Staff,
gangplank	Trinity Force,Ninja Tabi,Stormrazor,Sterak's Gage,Guardian Angel,Zz'Rot Portal,
garen	The Black Cleaver,Ninja Tabi,Sterak's Gage,Dead Man's Plate,Spirit Visage,Death's Dance,
gnar	The Black Cleaver,Ninja Tabi,Frozen Mallet,Dead Man's Plate,Spirit Visage,Guardian Angel,
gragas	Enchantment: Runic Echoes,Sorcerer's Shoes,Morellonomicon,Zhonya's Hourglass,Rabadon's Deathcap,Banshee's Veil,
graves	Enchantment: Warrior,Berserker's Greaves,Stormrazor,The Black Cleaver,Phantom Dancer,Guardian Angel,
hecarim	Enchantment: Cinderhulk,Ninja Tabi,Trinity Force,Sterak's Gage,Dead Man's Plate,Spirit Visage,
heimerdinger	Sorcerer's Shoes,Zhonya's Hourglass,Morellonomicon,Liandry's Torment,Morellonomicon,Rabadon's Deathcap,
illaoi	The Black Cleaver,Ninja Tabi,Sterak's Gage,Death's Dance,Spirit Visage,Guardian Angel,
irelia	Ninja Tabi,Trinity Force,Titanic Hydra,Sterak's Gage,Guardian Angel,Randuin's Omen,
ivern	Boots of Mobility,Redemption,Athene's Unholy Grail,Ardent Censer,Knight's Vow,Locket of the Iron Solari,
janna	Boots of Mobility,Ardent Censer,Redemption,Remnant of the Watchers,Locket of the Iron Solari,Banshee's Veil,
jarvaniv	Enchantment: Warrior,Mercury's Treads,The Black Cleaver,Titanic Hydra,Guardian Angel,Dead Man's Plate,
jax	Enchantment: Bloodrazor,Mercury's Treads,Trinity Force,Guinsoo's Rageblade,Guardian Angel,Randuin's Omen,
jayce	Ninja Tabi,Duskblade of Draktharr,The Black Cleaver,Guardian Angel,Mortal Reminder,Death's Dance,
jhin	Stormrazor,Boots of Swiftness,Rapid Firecannon,Infinity Edge,Guardian Angel,The Bloodthirster,
jinx	Stormrazor,Berserker's Greaves,Runaan's Hurricane,Infinity Edge,Rapid Firecannon,Guardian Angel,
kaisa	Stormrazor,Berserker's Greaves,Guinsoo's Rageblade,Runaan's Hurricane,Infinity Edge,Guardian Angel,
kalista	Berserker's Greaves,Runaan's Hurricane,The Bloodthirster,Guardian Angel,Mortal Reminder,Mortal Reminder,
karma	Remnant of the Watchers,Sorcerer's Shoes,Ardent Censer,Redemption,Locket of the Iron Solari,Knight's Vow,
karthus	Enchantment: Runic Echoes,Sorcerer's Shoes,Morellonomicon,Rabadon's Deathcap,Void Staff,Zhonya's Hourglass,
kassadin	Rod of Ages,Sorcerer's Shoes,Archangel's Staff,Zhonya's Hourglass,Lich Bane,Rabadon's Deathcap,
katarina	Hextech Gunblade,Sorcerer's Shoes,Zhonya's Hourglass,Morellonomicon,Void Staff,Rabadon's Deathcap,
kayle	Berserker's Greaves,Nashor's Tooth,Guinsoo's Rageblade,Runaan's Hurricane,Rabadon's Deathcap,Guardian Angel,
kayn	Enchantment: Warrior,Ninja Tabi,The Black Cleaver,Spirit Visage,Guardian Angel,Dead Man's Plate,
kennen	Hextech Protobelt-01,Sorcerer's Shoes,Zhonya's Hourglass,Rabadon's Deathcap,Void Staff,Spellbinder,
khazix	Enchantment: Warrior,Ninja Tabi,Duskblade of Draktharr,The Black Cleaver,Guardian Angel,Ravenous Hydra,
kindred	Enchantment: Warrior,Berserker's Greaves,Stormrazor,Rapid Firecannon,Infinity Edge,Guardian Angel,
kled	Ninja Tabi,The Black Cleaver,Titanic Hydra,Sterak's Gage,Guardian Angel,Gargoyle Stoneplate,
kogmaw	Berserker's Greaves,Guinsoo's Rageblade,Runaan's Hurricane,Infinity Edge,Guardian Angel,Guardian Angel,
leblanc	Sorcerer's Shoes,Morellonomicon,Zhonya's Hourglass,Void Staff,Rabadon's Deathcap,Void Staff,
leesin	Enchantment: Warrior,Ninja Tabi,The Black Cleaver,Guardian Angel,Sterak's Gage,Ravenous Hydra,
leona	Boots of Mobility,Remnant of the Aspect,Locket of the Iron Solari,Knight's Vow,Zeke's Convergence,Warmog's Armor,
lissandra	Hextech Protobelt-01,Sorcerer's Shoes,Zhonya's Hourglass,Morellonomicon,Void Staff,Rabadon's Deathcap,
lucian	Berserker's Greaves,The Black Cleaver,Rapid Firecannon,Infinity Edge,Guardian Angel,Guardian Angel,
lulu	Boots of Mobility,Ardent Censer,Redemption,Remnant of the Watchers,Locket of the Iron Solari,Twin Shadows,
lux	Sorcerer's Shoes,Zhonya's Hourglass,Remnant of the Watchers,Twin Shadows,Remnant of the Watchers,Rylai's Crystal Scepter,
malphite	Ninja Tabi,Sunfire Cape,Abyssal Mask,Adaptive Helm,Frozen Heart,Gargoyle Stoneplate,
malzahar	Sorcerer's Shoes,Rylai's Crystal Scepter,Liandry's Torment,Void Staff,Luden's Pulse,Rabadon's Deathcap,
maokai	Ninja Tabi,Sunfire Cape,Spirit Visage,Righteous Glory,Adaptive Helm,Gargoyle Stoneplate,
masteryi	Enchantment: Bloodrazor,Berserker's Greaves,Guinsoo's Rageblade,Sterak's Gage,Guardian Angel,Frozen Mallet,
missfortune	Berserker's Greaves,Duskblade of Draktharr,The Black Cleaver,Rapid Firecannon,Guardian Angel,Lord Dominik's Regards,
mordekaiser	Rylai's Crystal Scepter,Sorcerer's Shoes,Liandry's Torment,Zhonya's Hourglass,Morellonomicon,Rabadon's Deathcap,
morgana	Boots of Mobility,Zhonya's Hourglass,Remnant of the Watchers,Redemption,Locket of the Iron Solari,Zeke's Convergence,
nami	Boots of Mobility,Ardent Censer,Redemption,Remnant of the Watchers,Locket of the Iron Solari,Remnant of the Watchers,
nasus	Ninja Tabi,Trinity Force,Frozen Heart,Spirit Visage,Thornmail,Dead Man's Plate,
nautilus	Remnant of the Aspect,Ninja Tabi,Knight's Vow,Zeke's Convergence,Locket of the Iron Solari,Thornmail,
neeko	Sorcerer's Shoes,Morellonomicon,Zhonya's Hourglass,Rabadon's Deathcap,Rabadon's Deathcap,Twin Shadows,
nidalee	Enchantment: Runic Echoes,Sorcerer's Shoes,Lich Bane,Zhonya's Hourglass,Rabadon's Deathcap,Void Staff,
nocturne	Enchantment: Warrior,Ninja Tabi,Duskblade of Draktharr,Guardian Angel,Sterak's Gage,Adaptive Helm,
nunu	Enchantment: Cinderhulk,Mercury's Treads,Dead Man's Plate,Spirit Visage,Warmog's Armor,Gargoyle Stoneplate,
olaf	Enchantment: Cinderhulk,Ninja Tabi,Righteous Glory,Dead Man's Plate,Spirit Visage,Frozen Heart,
orianna	Sorcerer's Shoes,Morellonomicon,Zhonya's Hourglass,Liandry's Torment,Liandry's Torment,Rabadon's Deathcap,
ornn	Ninja Tabi,Forgefire Cape,Infernal Mask,Warmog's Armor,Gargoyle Stoneplate,Knight's Vow,
pantheon	Enchantment: Warrior,Boots of Mobility,The Black Cleaver,Guardian Angel,Dead Man's Plate,Thornmail,
poppy	Ninja Tabi,Sunfire Cape,Spirit Visage,Dead Man's Plate,Trinity Force,Warmog's Armor,
pyke	Boots of Mobility,Duskblade of Draktharr,Remnant of the Aspect,Guardian Angel,Maw of Malmortius,The Black Cleaver,
quinn	Berserker's Greaves,Stormrazor,Statikk Shiv,Infinity Edge,Guardian Angel,The Bloodthirster,
rakan	Boots of Mobility,Remnant of the Ascended,Zeke's Convergence,Redemption,Redemption,Ardent Censer,
rammus	Enchantment: Cinderhulk,Ninja Tabi,Thornmail,Dead Man's Plate,Righteous Glory,Frozen Heart,
reksai	Enchantment: Warrior,Ninja Tabi,The Black Cleaver,Titanic Hydra,Sterak's Gage,Guardian Angel,
renekton	Ninja Tabi,The Black Cleaver,Sterak's Gage,Guardian Angel,Titanic Hydra,Spirit Visage,
rengar	Enchantment: Warrior,Ninja Tabi,Duskblade of Draktharr,The Black Cleaver,Ravenous Hydra,Guardian Angel,
riven	Ninja Tabi,The Black Cleaver,Death's Dance,Guardian Angel,Ravenous Hydra,Sterak's Gage,
rumble	Liandry's Torment,Sorcerer's Shoes,Zhonya's Hourglass,Rylai's Crystal Scepter,Void Staff,Rabadon's Deathcap,
ryze	Archangel's Staff,Mercury's Treads,Morellonomicon,Zhonya's Hourglass,Rabadon's Deathcap,Void Staff,
sejuani	Enchantment: Cinderhulk,Ninja Tabi,Warmog's Armor,Gargoyle Stoneplate,Randuin's Omen,Knight's Vow,
shaco	Berserker's Greaves,Duskblade of Draktharr,Trinity Force,Guardian Angel,Titanic Hydra,Titanic Hydra,
shen	Ninja Tabi,Sunfire Cape,Titanic Hydra,Spirit Visage,Warmog's Armor,Gargoyle Stoneplate,
shyvana	Enchantment: Bloodrazor,Mercury's Treads,Titanic Hydra,Frozen Mallet,Dead Man's Plate,Spirit Visage,
singed	Ninja Tabi,Rylai's Crystal Scepter,Liandry's Torment,Righteous Glory,Zz'Rot Portal,Righteous Glory,
sion	Ninja Tabi,Sunfire Cape,Spirit Visage,Gargoyle Stoneplate,Thornmail,Adaptive Helm,
sivir	Stormrazor,Berserker's Greaves,Rapid Firecannon,Infinity Edge,Guardian Angel,The Bloodthirster,
skarner	Enchantment: Warrior,Mercury's Treads,Dead Man's Plate,Sterak's Gage,Randuin's Omen,Gargoyle Stoneplate,
sona	Ardent Censer,Sorcerer's Shoes,Redemption,Remnant of the Watchers,Athene's Unholy Grail,Twin Shadows,
soraka	Ionian Boots of Lucidity,Ardent Censer,Redemption,Remnant of the Watchers,Locket of the Iron Solari,Warmog's Armor,
swain	Rod of Ages,Sorcerer's Shoes,Zhonya's Hourglass,Liandry's Torment,Morellonomicon,Rabadon's Deathcap,
sylas	Sorcerer's Shoes,Morellonomicon,Zhonya's Hourglass,Void Staff,Banshee's Veil,Sorcerer's Shoes,
syndra	Sorcerer's Shoes,Morellonomicon,Zhonya's Hourglass,Rabadon's Deathcap,Zhonya's Hourglass,Void Staff,
tahmkench	Remnant of the Aspect,Boots of Swiftness,Locket of the Iron Solari,Knight's Vow,Redemption,Gargoyle Stoneplate,
taliyah	Enchantment: Runic Echoes,Sorcerer's Shoes,Morellonomicon,Zhonya's Hourglass,Void Staff,Rabadon's Deathcap,
talon	Boots of Mobility,Duskblade of Draktharr,The Black Cleaver,Guardian Angel,Ravenous Hydra,Stormrazor,
taric	Remnant of the Aspect,Mercury's Treads,Zeke's Convergence,Locket of the Iron Solari,Righteous Glory,Frozen Heart,
teemo	Liandry's Torment,Sorcerer's Shoes,Nashor's Tooth,Void Staff,Rabadon's Deathcap,Morellonomicon,
thresh	Boots of Mobility,Remnant of the Ascended,Knight's Vow,Locket of the Iron Solari,Redemption,Zeke's Convergence,
tristana	Stormrazor,Berserker's Greaves,Rapid Firecannon,Infinity Edge,The Bloodthirster,Guardian Angel,
trundle	Enchantment: Warrior,Ninja Tabi,Trinity Force,Dead Man's Plate,Spirit Visage,Randuin's Omen,
tryndamere	Berserker's Greaves,Phantom Dancer,Infinity Edge,Death's Dance,Ravenous Hydra,Trinity Force,
twistedfate	Rod of Ages,Ionian Boots of Lucidity,Lich Bane,Zhonya's Hourglass,Rabadon's Deathcap,Rapid Firecannon,
twitch	Berserker's Greaves,Runaan's Hurricane,Infinity Edge,Statikk Shiv,Guardian Angel,The Bloodthirster,
udyr	Enchantment: Warrior,Mercury's Treads,Trinity Force,Dead Man's Plate,Spirit Visage,Thornmail,
urgot	The Black Cleaver,Ninja Tabi,Righteous Glory,Gargoyle Stoneplate,Thornmail,Frozen Heart,
varus	Berserker's Greaves,Guinsoo's Rageblade,Runaan's Hurricane,Infinity Edge,Guardian Angel,The Bloodthirster,
vayne	Berserker's Greaves,Guinsoo's Rageblade,Phantom Dancer,Infinity Edge,Guardian Angel,Guardian Angel,
veigar	Sorcerer's Shoes,Zhonya's Hourglass,Rabadon's Deathcap,Spellbinder,Lich Bane,Lich Bane,
velkoz	Sorcerer's Shoes,Zhonya's Hourglass,Remnant of the Watchers,Morellonomicon,Rabadon's Deathcap,Rylai's Crystal Scepter,
vi	Enchantment: Warrior,Ninja Tabi,Trinity Force,Sterak's Gage,Guardian Angel,Dead Man's Plate,
viktor	Perfect Hex Core,Sorcerer's Shoes,Lich Bane,Rylai's Crystal Scepter,Void Staff,Rabadon's Deathcap,
vladimir	Hextech Protobelt-01,Sorcerer's Shoes,Rabadon's Deathcap,Zhonya's Hourglass,Void Staff,Morellonomicon,
volibear	Enchantment: Cinderhulk,Mercury's Treads,Dead Man's Plate,Spirit Visage,Thornmail,Righteous Glory,
warwick	Enchantment: Cinderhulk,Ninja Tabi,Titanic Hydra,Spirit Visage,Dead Man's Plate,Guardian Angel,
wukong	Enchantment: Warrior,Boots of Mobility,Duskblade of Draktharr,The Black Cleaver,Guardian Angel,Knight's Vow,
xayah	Stormrazor,Berserker's Greaves,Rapid Firecannon,Infinity Edge,Guardian Angel,Mercurial Scimitar,
xerath	Sorcerer's Shoes,Morellonomicon,Rabadon's Deathcap,Banshee's Veil,Banshee's Veil,Void Staff,
xinzhao	Enchantment: Warrior,Ninja Tabi,Trinity Force,Sterak's Gage,Guardian Angel,Dead Man's Plate,
yasuo	Berserker's Greaves,Phantom Dancer,Infinity Edge,Sterak's Gage,Guardian Angel,The Bloodthirster,
yorick	Ninja Tabi,Trinity Force,Sterak's Gage,Zz'Rot Portal,Titanic Hydra,Dead Man's Plate,
zac	Enchantment: Cinderhulk,Ninja Tabi,Warmog's Armor,Spirit Visage,Thornmail,Locket of the Iron Solari,
zed	Duskblade of Draktharr,Mercury's Treads,The Black Cleaver,Guardian Angel,Lord Dominik's Regards,Lord Dominik's Regards,
ziggs	Sorcerer's Shoes,Morellonomicon,Rabadon's Deathcap,Zhonya's Hourglass,Liandry's Torment,Liandry's Torment,
zilean	Sorcerer's Shoes,Archangel's Staff,Mejai's Soulstealer,Rabadon's Deathcap,Morellonomicon,Remnant of the Watchers,
zoe	Sorcerer's Shoes,Morellonomicon,Zhonya's Hourglass,Void Staff,Rabadon's Deathcap,Void Staff,
zyra	Sorcerer's Shoes,Liandry's Torment,Rylai's Crystal Scepter,Remnant of the Watchers,Zhonya's Hourglass,Void Staff,
